[
  [" "," "," "," "," "," "," "," "," "," "," "," "," "," "," "," "," "," "," "," "],
  [" "," "," "," "," "," "," "," "," "," "," "," "," "," "," "," "," "," "," "," "],
  ["b","b","b","b","b"," "," "," "," "," "," "," "," "," "," "," "," "," "," "," "],
  [" "," "," "," "," "," "," "," "," "," "," "," "," "," "," "," "," "," "," "," "],
  [" "," "," "," "," "," "," "," ","a","a","a"," "," "," "," "," "," "," "," "," "],
  [" "," "," "," "," ","b","b","b","b","b","b"," "," "," "," "," "," "," "," "," "],
  [" "," "," "," "," "," "," "," "," "," "," "," "," "," "," "," "," "," "," "," "],
  [" "," "," "," "," "," "," "," "," "," "," "," "," "," "," "," "," "," "," "," "],
  ["a","a"," "," "," ","d"," "," "," "," "," "," "," "," "," "," "," "," "," "," "],
  ["b","b"," "," "," ","b"," "," "," "," "," "," "," "," "," "," "," "," "," "," "],
  [" "," "," "," "," "," "," "," "," "," "," "," "," "," "," "," "," "," "," "," "],
  [" "," "," "," "," "," "," "," "," "," "," "," "," "," "," "," "," "," "," "," "],
  ["a","a"," "," "," "," "," "," "," "," "," "," "," "," "," "," "," "," "," "," "],
  [" "," "," "," "," "," "," "," "," "," "," "," "," "," "," "," "," "," "," "," "],
  []
]